████████████████████████████████████████████████████████████████████████
█                                                                      █
█                                                                      █
█                                                                      █
█                                 X                                    █
█                                                                      █
█                                                                      █
█                                                                      █
█                        ████████                                      █
█                        ████████                                      █
█                        ████████                                      █
█                        ████████               $                      █
█               H                                                      █
█                                                                      █
█                                                                      █
█                                                                      █
█                                                                      █
█                                                                      █
█                                           ████████                   █
█                                           ████████                   █
█                                           ████████                   █
█                                           ████████                   █
█                            D                                         █
█                                                                      █
█                                                                      █
█                                                                      █
█                                                                      █
████████████████████████████████████████████████████████████████████████