████████████████████████████████████████████████████████████████████████
█                                                                      █
█                                                                      █
█                                                                      █
█                                                                      █
█                                                                      █
█                                                                      █
█                                                                      █
█                        ████████                                      █
█                        ████████                                      █
█                        ████████                                      █
█                        ████████                                      █
█                                                                      █
█                                                                      █
█                                                                      █
█            H    B                                                    █
█                                                                      █
█                                                                      █
█                                           ████████                   █
█                                           ████████                   █
█                                           ████████                   █
█                                           ████████                   █
█                                                                      █
█                                                                      █
█                                                                      █
█                                                                      █
█                                                                      █
████████████████████████████████████████████████████████████████████████